Federal Energy Regulatory Commission	FERC
US Department of Energy	USDOE
U.S. Department of Energy	USDOE
US Army Corps of Engineers	USACE
U.S. Army Corps of Engineers	USACE
US Department of Transportation	USDOT
U.S. Department of Transportation	USDOT
US Environmental Protection Agency	USEPA
U.S. Environmental Protection Agency	USEPA
Golden Pass Products LLC	GPP
US Coast Guard	USCG
U.S. Coast Guard	USCG
Coast Guard	USCG
National Oceanic and Atmospheric Administration Fisheries	NOAAF
Texas Parks and Wildlife Department	TPWD
Louisiana Department of Wildlife and Fisheries	LDWF
Louisiana Department of Culture, Recreation, and Tourism, Division of Archaeology	LDCRTA
US Department of Defense	USDOD
U.S. Department of Defense	USDOD
Jefferson County, Texas	JEFF
Orange County, Texas	ORANGE
National Resource Conservation Service	NRCS
Calcasieu Parish	CALAS
Texas Commission on Environmental Quality	TCEQ
Texas Parks and Wildlife Department	TPWD
Louisiana Division of Historic Preservation	LDHP
Texas Historical Commission	THC
Alabama-Coushatta Tribe of Texas	ALCOUS
Caddo Nation of Oklahoma	CADDO
Chitimacha Tribe of Louisiana	CHITI
Coushatta Tribe of Louisiana	COUSH
Jena Band of Choctaw Indians	JENA
Mississippi Band of Choctaw Indians	CHOC_MS
Quapaw Tribe of Indians, Tonkawa Tribe of Oklahoma	QUAP
Tunica-Biloxi Indians of Louisiana	TUNI
Sabine Pass LNG	SPLNG
Tennessee Valley Authority	TVA
US Fish and Wildlife Service	USFWS
U.S. Fish and Wildlife Service	USFWS
United Keetowah Band of Cherokee Indians	UKB
US Department of Interior	USDOI
U.S. Department of Interior	USDOI
Tennessee Historical Commission	TNHC
Bureau of Ocean Energy Management, Regulation and Enforcement	BOEMRE
Bureau of Ocean Energy Management Regulation and Enforcement	BOEMRE
Bureau of Ocean Energy Management	BOEM
Bureau of Safety and Environmental Enforcement	BSEE
National Oceanic and Atmospheric Administration National Marine Fisheries Service	NMFS
Leucadia Energy, LLC	LEUC
Leucadia Energy	LEUC
Ecology and Environment, Inc.	ECOENV
Ecology and Environment	ECOENV
Choctaw Nation	CHOCTAW
Louisiana Natural Heritage Program	LNHP
Denbury	DEN
Lake Charles Cogeneration, LLC	LKCHAR
Lake Charles Cogeneration	LKCHAR
William Self Associates Inc. (WSA)	WSA
William Self Associates Inc.	WSA
William Self Associates	WSA
Dial Cordy and Associates Inc.	DCA
Dial Cordy and Associates	DCA
US Army Corps of Engineers Wilmington District	USACE_WD
U.S. Army Corps of Engineers Wilmington District	USACE_WD
Carteret County	CARTERET
Town of Atlantic Beach	ATLANTIC
Town of Pine Knoll Shores	PINE
Town of Indian Beach	INDIAN
Town of Emerald Isle	EMERALD
US Army Corps of Engineers Wilmington District	USACE_JD
U.S. Army Corps of Engineers Wilmington District	USACE_JD
US Nuclear Regulatory Commission	USNRC
U.S. Nuclear Regulatory Commission	USNRC
Florida Power and Light Company	FPL
Advisory Council on Historic Preservation	ACHP
Florida Fish and Wildlife Conservation Commission	FFWCC
National Marine Fisheries Service	NMFS
Miami-Dade Office of Historic and Archaeological Resources	MDOHAR
Florida Division of Historical Resources	FDHR
Seminole Tribe of Florida	SEMINOLE
Miccosukee Tribe of Indians of Florida	MICCO
Tennessee Department of Transportation	TDOT
Parsons Brinckerhoff Inc.	PARSONS
Parsons Brinckerhoff	PARSONS
US Department of Transportation Federal Highway Administration	USDOT_FHA
Eastern Band of the Cherokee	ECHEROKEE
Bowlby and Associates	BOWLBY
Civil and Environmental Consultant, Inc.	CIVIL
Civil and Environmental Consultant	CIVIL
Panamerican Consulting	PANA
KS Ware and Associates	KSWARE
K.S. Ware and Associates	KSWARE
Alabama Historical Commission	AHC
Georgia Department of Natural Resources Historic Preservation Division	GDNR_HPD
Mississippi Department of Archives and History State Historic Preservation Office	MDAH_SHPO
Kentucky Heritage Council	KHC
North Carolina Department of Natural and Cultural Resources Historical Commission	NCDNCR
Virginia Department of Historic Resources	VADHR
US Department of Energy Advanced Research Projects Agency	USDOE_ARPA
US Department of Agriculture Forest Service	USDA_FS
US Department of Agriculture Animal and Plant Inspection Service	USDA_APHIS
US Fish and Wildlife Serfice Mississippi Field Office	USFWS_MS
US Fish and Wildlife Service Louisiana Office	USFWS_LA
Choctaw Nation of Oklahoma	CHOC_OK
Mississippi Natural Heritage Program	MNHP
US Department of Energy Office of Fossil Energy	USDOI_OFE
City of Norfolk	NORFOLK
VHB	VHB
Housing and Urban Development	HUD
Virginia Department of Environmental Quality	VADEQ
Chickahominy Tribe	CHICK
Eastern Chickahominy Tribe	ECHICK
Upper Mattaponi Tribe	UMATT
Nansemond Tribe	NANSE
Monacan Indian Nation	MONA
Delaware Nation	DELA
Pamunkey Indian Tribe	PAMU
Driftwood LNG, LLC	DRIFT
Driftwood LNG	DRIFT
Driftwood Pipeline, LLC	DRIFT
Driftwood Pipeline	DRIFT
Driftwood LNG, LLC and Driftwood Pipeline, LLC (collectively, "Driftwood")	DRIFT
Driftwood	DRIFT
Louisiana Department of Natural Resources Office of Coastal Management	LDNR_OCM
Venture Global LNG	VENTURE
Magnolia LNG	MAG
Moran Shipping	MORAN
COTP Marine Safety Unit	COTP_MSU
ABS Consulting	ABS
Marine Pilots Institute of Covington	MPIC
Bechtel	BECHT
Port of Lake Charles	PORT
Lake Charles Pilots	LCPILOT
Louisiana State Police	LAPOL
National Park Service Environmental Quality Division	NPS_EQD
National Park Service Big South Fork NRRA	NPS_BSF
National Park Service Southeast Region	NPS_SE
National Park Service Water Resources Division	NPS_WRD
National Park Service Geological Resources Division	NPS_GRD
Wood Environment and Infrastructure Solutions, Inc.	WOOD
National Park Service	NPS
US Department of Interior Office of Surface Mining	USDOI_OSM
U.S. Department of Interior Office of Surface Mining	USDOI_OSM
Kentucky Department for Environmental Protection	KDEP
Tennessee Department of Environment and Conservation	TDEC
Kentucky State Clearinghouse	KSC
Columbia Gulf Transmission, LLC	CGT
Gulf Xpress Project	GXP
West Virginia Department of Environmental Protection	WVDEP
West Virginia Division of Natural Resources (WVDNR)	WVDNR
West Virginia Division of Natural Resources	WVDNR
US Fish and Wildlife Service West Virginia Field Office	USFWS_WV
U.S. Fish and Wildlife Service West Virginia Field Office	USFWS_WV
Columbia Gas	CGAS
West Virginia Division of Culture and History	WVDCH
West Virginia Department of Natural Resources Natural Heritage Program	WVDNR_NHP
West Virginia Department of Natural Resources – Natural Heritage Program	WVDNR_NHP
West Virginia Department of Natural Resources - Natural Heritage Program	WVDNR_NHP
West Virginia Department of Natural Resources -- Natural Heritage Program	WVDNR_NHP
Kentucky Department of Fish and Wildlife Resources	KDFWR
Mississippi Department of Archives and History State Historic Preservation Office	MDAH
Mississippi Department of Wildlife, Fish, and Parks Museum of Natural Science	MDWFP_MNS
Mississippi Department of Wildlife, Fish, and Parks – Museum of Natural Science	MDWFP_MNS
Mississippi Department of Wildlife, Fish, and Parks - Museum of Natural Science	MDWFP_MNS
Mississippi Department of Wildlife, Fish, and Parks -- Museum of Natural Science	MDWFP_MNS
West Virginia Department of Health and Human Resources	WVDHHR
Mississippi Department of Environmental Quality	MDEQ
National Resource Conservation Service West Virginia Office	NRCS_WV
Mississippi Department of Wildlife, Fish, and Parks	MDWFP
Seneca Nation of Indians	SENECA
Accomack County	ACCOMACK
Division of Economics US Fish and Wildlife Service	USFWS_DE
North American Waterfowl Management Plan Committee	NAWMP
North American Waterbird Conservation Plan	NAWCP
US Shorebird Conservation Plan Council	USSCP
U.S. Shorebird Conservation Plan Council	USSCP
Partners in Flight Conservation Plans	PIF
US Environmental Protection Agency Region 4	USEPA_4
U.S. Environmental Protection Agency Region 4	USEPA_4
ANAMAR Environmental Consulting, Inc.	ANAMAR
ANAMAR Environmental Consulting	ANAMAR
Anamar Environmental Consulting, Inc.	ANAMAR
Anamar Environmental Consulting	ANAMAR
US Army Corps of Engineers Jacksonville District	USACE_JD
U.S. Army Corps of Engineers Jacksonville District	USACE_JD
US Army Corps of Engineers Chief Environmental Branch	USACE_CEB
U.S. Army Corps of Engineers Chief Environmental Branch	USACE_CEB
North Jax Civic Association	NJCA
Florida Department of Environmental Protection	FDEP
US Army Corps of Engineers Planning Division	USACE_PD
U.S. Army Corps of Engineers Planning Division	USACE_PD
US Army Corps of Engineers Ocean Dumping Management	USEPA_ODM
U.S. Army Corps of Engineers Ocean Dumping Management	USEPA_ODM
Florida Department of State Division of Historical Resources	FDOS_DHS
US Department of Interior Regional Environmental Protection	USDOI_REP
U.S. Department of Interior Regional Environmental Protection	USDOI_REP
US Environmental Protection Agency Wetlands, Coastal, and Ocean Branch	USEPA_WCOB
U.S. Environmental Protection Agency Wetlands, Coastal, and Ocean Branch	USEPA_WCOB
National Oceanic and Atmospheric Administration Southeast Regional Office	NOAA_SE
National Marine Fisheries Service Southeast Regional Office	NMFS_SRO
Alabama Department of Conservation and Natural Resources	ADOCNR
Geological Survey of Alabama	GSAL
National Park Service	NPS
US Department of Agriculture	USDA
U.S. Department of Agriculture	USDA
Alabama Department of Environmental Management	ADEM
National Oceanic and Atmospheric Administration Gulf of Mexico Disaster Response Center	NOAA_GMDRC
US Fish and Wildlife Service Alabama Ecological Services Field Office	USFWS_ALES
U.S. Fish and Wildlife Service Alabama Ecological Services Field Office	USFWS_ALES
US Department of Interior Deepwater Horizon Case Management Office	USDOI_DWH
U.S. Department of Interior Deepwater Horizon Case Management Office	USDOI_DWH
National Park Service Fort Raleigh National Historic Site	NPS_FRNHS
National Park Service Denver Service Center	NPS_DSC
Parsons Infrastructure and Technology	PARSONS_IT
Tuscarora Nation	TUCSA
Kinder Morgan	KMORG
Lake Charles Regional Airport	LCRA
Transcontinental Gas Pipe Line Company, LLC (Transco)	TRANSCO
Transcontinental Gas Pipe Line Company, LLC	TRANSCO
Transcontinental Gas Pipe Line Company	TRANSCO
Transco	TRANSCO
Pennsylvania Department of Transportation	PDOT
Reading Company Technical and Historical Society	RCTHS
Port Arthur LNG	PALNG
Port Arthur Pipeline, LLC	PAPL
JD Murphree WMA	JDMWMA
J.D. Murphree WMA	JDMWMA
Area Maritime Security Committee	AMSC
Harbor Safety Committee	HSC
Seminole Tribe of Oklahoma	SEM_OK
Venture Calcasieu Pass	VENTURE_CP
Louisiana Department of Natural Resources	LDNR
Sabine River Authority of Texas	SAB_TX
Sabine River Authority, State of Louisiana	SAB_LA
US Navy	NAVY
U.S. Navy	NAVY
Navy	NAVY
North Carolina Division of Coastal Management	NCDCM
North Carolina	NC
Georgia Department of Transportation	GADOT
Georgia Department of Natural Resources Coastal Resources Division	GDNR_CRD
Savannah State University	SSU
Georgia Historical Society	GHS
Savannah Pilots Association	SPA
Tybee Island City Council	TICC
Coastal Georgia Regional Council	CGRDC
Savannah/Chatham County Police Department	SPD
Tybee Island Historic Society	THIS
Chatham County Public Works and Parks Department	CCPW
Oatland Island Education Center	OIEC
Georgia Land Trust	GLAND
Metropolitan Planning Commission	MPC
National Park Service, Denver Service Center	NPS_DSC
US Fish and Wildlife Service Savannah Refuge Complex Office	USFWS_SRCO
U.S. Fish and Wildlife Service Savannah Refuge Complex Office	USFWS_SRCO
Georgia Historic Preservation Division	GHPD
Georgia Coastal Resources Division	GCRD
Chatham County Savannah Metropolitan Planning Commission	CC_SMPC
Chatham County – Savannah Metropolitan Planning Commission	CC_SMPC
Chatham County - Savannah Metropolitan Planning Commission	CC_SMPC
Chatham County -- Savannah Metropolitan Planning Commission	CC_SMPC
National Parks Conservation Association	NPCA
Georgia Conservancy	GACON
Kentucky Department of Highways	KDH
Atlantic Coast Pipeline, LLC	ACP
Atlantic Coast Pipeline	ACP
Dominion Energy Transmission, Inc.	DETI
Dominion Energy Transmission	DETI
Westmoreland Conservancy	WESTC
National Partk Service ANST Office	NPS_ANST
National Partk Service – ANST Office	NPS_ANST
National Partk Service - ANST Office	NPS_ANST
National Partk Service -- ANST Office	NPS_ANST
US Fish and Wildlife Service Virginia Field Office	USFWS_VA
U.S. Fish and Wildlife Service Virginia Field Office	USFWS_VA
US Fish and Wildlife Service North Carolina Field Office	USFWS_NC
U.S. Fish and Wildlife Service North Carolina Field Office	USFWS_NC
US Fish and Wildlife Service Pennsylvania Office	USFWS_PA
U.S. Fish and Wildlife Service Pennsylvania Office	USFWS_PA
Virginia Department of Agriculture and Consumer Services	VADACS
Virginia Department of Game and Inland Fisheries	VADGIF
North Carolina Natural Heritage Program	NCNHP
North Carolina State Historic Preservation Office	NCSHPO
North Carolina Wildlife Resources Commission	NCWRC
Pennsylvania Department of Conservation and Natural Resources	PADCNR
Pennsylvania Historical and Museum Commission, Bureau for Historic Preservation	PAHMC
Pennsylvania Historical and Museum Commission	PAHMC
West Virginia Geological and Economic Survey	WVGES
Virginia Department of Mines, Minerals, and Energy	VDMME
North Carolina Geological Survey	NCGS
Virginia Department of Health Office of Drinking Water	VDH_ODW
Virginia Department of Health – Office of Drinking Water	VDH_ODW
Virginia Department of Health - Office of Drinking Water	VDH_ODW
Virginia Department of Health -- Office of Drinking Water	VDH_ODW
Monongahela National Forest	MNF
George Washington National Forest	GWNF
Virginia Department of Conservation and Recreation	VADCR
Pennsylvania Fish and Boat Commission	PAFBC
Virginia Speleological Survey	VASS
West Virginia Speleological Survey	WVSS
Virginia Cave Conservancy	VCC
Karst Waters Institute	KWI
Pennsylvania Natural Heritage Program	PNHP
Wintergreen Resort	WINTER
Spruce Creek Resort and Market	SPRUCE
McClauren Subdivision	MCCLAUREN
West Virginia State Parks	WVSP
Shenandoah Valley Battlefields Foundation	SVBF
Catawba Indian Nation	CATAWBA
Eastern Shawnee Tribe of Oklahoma	ESHAWNEE
Tonawanda Band of Seneca Indians	TONAWANDA
Tuscarora Nation	TUCSARORA
Appalachian Trail Conservancy	ATC
Barry Graham Oil Service	BGOS
City of Coral Gables	CGABLES
South Florida Water Management District	CGABLES
US Fish and Wildlife Service Ohio Ecological Services Field Office	USFWS_OH
U.S. Fish and Wildlife Service Ohio Ecological Services Field Office	USFWS_OH
US Fish and Wildlife Service Region 5 Migratory Bird Permit Office	USFWS_MBPO
U.S. Fish and Wildlife Service Region 5 Migratory Bird Permit Office	USFWS_MBPO
Kentucky State Nature Preserve Commission	KYSNPC
Kentucky State Department of Fish and Wildlife Resources	KYDFWR
Kentucky Division of Forestry	KYDOF
Ohio Environmental Protection Agency	OHEPA
Ohio Department of Natural Resources	OHDNR
West Virginia Natural Resources Conservation Service	WVNRCS
Ohio State Historic Preservation Office	OHSHPO
Pennsylvania State Historic Preservation Office	PASHPO
Kentucky State Historic Preservation Office	KYSHPO
Council on Environmental Quality	CEQ
Miami-Dade County	MDADE
Everglades National Park	EVERNP
Biscayne National Park	BISCNP
Miami-Dade County Department of Environmental Resources Management	MDC_DERM
Miami-Dade County Department of Planning and Zoning	MDC_DPZ
Miami-Dade Limestone Products Association	MDLPA
Miami-Dade Department of Environmental Resources	MDDER
South Florida Water Management District	SFWMD
Washington Metropolitan Airport Authority	WMAA
Louis Berger Group	LBGROUP
FERC	FERC
USDOE	USDOE
USACE	USACE
USDOT	USDOT
USEPA	USEPA
GPP	GPP
USCG	USCG
NOAAF	NOAAF
TPWD	TPWD
LDWF	LDWF
LDCRTA	LDCRTA
USDOD	USDOD
NRCS	NRCS
TCEQ	TCEQ
TPWD	TPWD
LDHP	LDHP
THC	THC
SPLNG	SPLNG
TVA	TVA
USFWS	USFWS
UKB	UKB
USDOI	USDOI
TNHC	TNHC
BOEMRE	BOEMRE
BOEM	BOEM
BSEE	BSEE
NMFS	NMFS
ECOENV	ECOENV
LNHP	LNHP
LKCHAR	LKCHAR
WSA	WSA
DCA	DCA
USACE WD	USACE_WD
USACE-WD	USACE_WD
USACEWD	USACE_WD
USACE JD	USACE_JD
USACE-JD	USACE_JD
USACEJD	USACE_JD
USNRC	USNRC
FPL	FPL
ACHP	ACHP
FFWCC	FFWCC
NMFS	NMFS
MDOHAR	MDOHAR
FDHR	FDHR
TDOT	TDOT
USDOT FHA	USDOT_FHA
USDOT-FHA	USDOT_FHA
USDOTFHA	USDOT_FHA
AHC	AHC
GDNR HPD	GDNR_HPD
GDNR-HPD	GDNR_HPD
GDNRHPD	GDNR_HPD
MDAH SHPO	MDAH_SHPO
MDAH-SHPO	MDAH_SHPO
MDAHSHPO	MDAH_SHPO
KHC	KHC
NCDNCR	NCDNCR
VADHR	VADHR
USDOE ARPA	USDOE_ARPA
USDOE-ARPA	USDOE_ARPA
USDOEARPA	USDOE_ARPA
USDA FS	USDA_FS
USDA-FS	USDA_FS
USDAFS	USDA_FS
USDA APHIS	USDA_APHIS
USDA-APHIS	USDA_APHIS
USDAAPHIS	USDA_APHIS
USFWS MS	USFWS_MS
USFWS-MS	USFWS_MS
USFWSMS	USFWS_MS
USFWS LA	USFWS_LA
USFWS-LA	USFWS_LA
USFWSLA	USFWS_LA
MNHP	MNHP
USDOI OFE	USDOI_OFE
USDOI-OFE	USDOI_OFE
USDOIOFE	USDOI_OFE
VHB	VHB
HUD	HUD
VADEQ	VADEQ
LDNR OCM	LDNR_OCM
LDNR-OCM	LDNR_OCM
LDNROCM	LDNR_OCM
COTP MSU	COTP_MSU
COTP-MSU	COTP_MSU
COTPMSU	COTP_MSU
ABS	ABS
MPIC	MPIC
NPS EQD	NPS_EQD
NPS-EQD	NPS_EQD
NPSEQD	NPS_EQD
NPS BSF	NPS_BSF
NPS-BSF	NPS_BSF
NPSBSF	NPS_BSF
NPS SE	NPS_SE
NPS-SE	NPS_SE
NPSSE	NPS_SE
NPS WRD	NPS_WRD
NPS-WRD	NPS_WRD
NPSWRD	NPS_WRD
NPS GRD	NPS_GRD
NPS-GRD	NPS_GRD
NPSGRD	NPS_GRD
NPS	NPS
USDOI OSM	USDOI_OSM
USDOI-OSM	USDOI_OSM
USDOIOSM	USDOI_OSM
KDEP	KDEP
TDEC	TDEC
KSC	KSC
CGT	CGT
GXP	GXP
WVDEP	WVDEP
WVDNR	WVDNR
USFWS WV	USFWS_WV
USFWS-WV	USFWS_WV
USFWSWV	USFWS_WV
WVDCH	WVDCH
WVDNR NHP	WVDNR_NHP
WVDNR-NHP	WVDNR_NHP
WVDNRNHP	WVDNR_NHP
KDFWR	KDFWR
MDAH	MDAH
MDWFP MNS	MDWFP_MNS
MDWFP-MNS	MDWFP_MNS
MDWFPMNS	MDWFP_MNS
WVDHHR	WVDHHR
MDEQ	MDEQ
NRCS WV	NRCS_WV
NRCS-WV	NRCS_WV
NRCSWV	NRCS_WV
MDWFP	MDWFP
USFWS DE	USFWS_DE
USFWS-DE	USFWS_DE
USFWSDE	USFWS_DE
NAWMP	NAWMP
NAWCP	NAWCP
USSCP	USSCP
PIF	PIF
USEPA 4	USEPA_4
USACE JD	USACE_JD
USACE-JD	USACE_JD
USACEJD	USACE_JD
USACE CEB	USACE_CEB
USACE-CEB	USACE_CEB
USACECEB	USACE_CEB
NJCA	NJCA
FDEP	FDEP
USACE PD	USACE_PD
USACE-PD	USACE_PD
USACEPD	USACE_PD
USEPA ODM	USEPA_ODM
USEPA-ODM	USEPA_ODM
USEPAODM	USEPA_ODM
FDOS DHS	FDOS_DHS
FDOS-DHS	FDOS_DHS
FDOS_DHS	FDOS_DHS
USDOI REP	USDOI_REP
USDOI-REP	USDOI_REP
USDOIREP	USDOI_REP
USEPA WCOB	USEPA_WCOB
USEPA-WCOB	USEPA_WCOB
USEPAWCOB	USEPA_WCOB
NOAA SE	NOAA_SE
NOAA-SE	NOAA_SE
NOAASE	NOAA_SE
NMFS SRO	NMFS_SRO
NMFS-SRO	NMFS_SRO
NMFSSRO	NMFS_SRO
ADOCNR	ADOCNR
NPS	NPS
USDA	USDA
ADEM	ADEM
NOAA GMDRC	NOAA_GMDRC
NOAA-GMDRC	NOAA_GMDRC
NOAAGMDRC	NOAA_GMDRC
USFWS ALES	USFWS_ALES
USFWS-ALES	USFWS_ALES
USFWSALES	USFWS_ALES
USDOI DWH	USDOI_DWH
USDOI-DWH	USDOI_DWH
USDOIDWH	USDOI_DWH
NPS FRNHS	NPS_FRNHS
NPS-FRNHS	NPS_FRNHS
NPSFRNHS	NPS_FRNHS
NPS DSC	NPS_DSC
NPS-DSC	NPS_DSC
NPSDSC	NPS_DSC
LCRA	LCRA
PDOT	PDOT
RCTHS	RCTHS
PALNG	PALNG
PAPL	PAPL
JDMWMA	JDMWMA
AMSC	AMSC
HSC	HSC
LDNR	LDNR
SAB TX	SAB_TX
SAB-TX	SAB_TX
SABTX	SAB_TX
SAB LA	SAB_LA
SAB-LA	SAB_LA
SABLA	SAB_LA
NCDCM	NCDCM
NC	NC
GADOT	GADOT
GDNR CRD	GDNR_CRD
GDNR-CRD	GDNR_CRD
GDNRCRD	GDNR_CRD
SSU	SSU
GHS	GHS
SPA	SPA
TICC	TICC
CGRDC	CGRDC
SPD	SPD
THIS	THIS
CCPW	CCPW
CCPWPD	CCPW
OIEC	OIEC
GLAND	GLAND
MPC	MPC
NPS DSC	NPS_DSC
NPS-DSC	NPS_DSC
NPSDSC	NPS_DSC
USFWS SRCO	USFWS_SRCO
USFWS-SRCO	USFWS_SRCO
USFWSSRCO	USFWS_SRCO
GHPD	GHPD
GCRD	GCRD
CC SMPC	CC_SMPC
CC-SMPC	CC_SMPC
CCSMPC	CC_SMPC
NPCA	NPCA
KDH	KDH
ACP	ACP
DETI	DETI
WESTC	WESTC
NPS ANST	NPS_ANST
NPS-ANST	NPS_ANST
NPSANST	NPS_ANST
USFWS VA	USFWS_VA
USFWS-VA	USFWS_VA
USFWSVA	USFWS_VA
USFWS NC	USFWS_NC
USFWS-NC	USFWS_NC
USFWSNC	USFWS_NC
USFWS PA	USFWS_PA
USFWS-PA	USFWS_PA
USFWSPA	USFWS_PA
VADACS	VADACS
VADGIF	VADGIF
NCNHP	NCNHP
NCSHPO	NCSHPO
NCWRC	NCWRC
PADCNR	PADCNR
PAHMC	PAHMC
WVGES	WVGES
VDMME	VDMME
NCGS	NCGS
VDH ODW	VDH_ODW
VDH-ODW	VDH_ODW
VDHODW	VDH_ODW
MNF	MNF
GWNF	GWNF
VADCR	VADCR
PAFBC	PAFBC
VASS	VASS
WVSS	WVSS
VCC	VCC
KWI	KWI
PNHP	PNHP
WVSP	WVSP
SVBF	SVBF
ATC	ATC
CCG	CGABLES
USFWS OH	USFWS_OH
USFWS-OH	USFWS_OH
USFWSOH	USFWS_OH
USFWS MBPO	USFWS_MBPO
USFWS-MBPO	USFWS_MBPO
USFWSMBPO	USFWS_MBPO
KYSNPC	KYSNPC
KYDFWR	KYDFWR
KYDOF	KYDOF
OHEPA	OHEPA
OHDNR	OHDNR
WVNRCS	WVNRCS
OHSHPO	OHSHPO
PASHPO	PASHPO
KYSHPO	KYSHPO
CEQ	CEQ
MDC DERM	MDC_DERM
MDC-DERM	MDC_DERM
MDCDERM	MDC_DERM
MDC DPZ	MDC_DPZ
MDC-DPZ	MDC_DPZ
MDCDPZ	MDC_DPZ
MDLPA	MDLPA
MD DER	MDDER
MD-DER	MDDER
MDDER	MDDER
SFWMD	SFWMD
WMAA	WMAA
